3,3,3,3,  3,3,3,  3,3,3,3,3,  3,  3,  3,  3,3,3,3,3
4,4,4,4,  4,4,4,  4,4,4,4,4,  4,  4,  4,  4,4,4,4,4
4,4,4,4,  4,4,4,4:2,4,4,4,4,  4,  4,  4,  4,4,4,4,4
4,4,4,4,4:0,4,4,4:1,4,4,4,4,4:0,4:0,4:0,4:0,4,4,4,4
5,5,5,5,  5,5,5,  5,5,5,5,5,  5,  5,  5,  5,5,5,5,5